ID,Entradas,Entradas_ganadas,Entradas_defensa,Entradas_medio_campo,Entradas_ataque,Regates_parados,Regates_recibidos,Porcent_regates_parados,Regates_perdidos,Bloqueos,Disparos_bloqueados,Pases_bloqueados,Intercepciones,Intercepciones_intentadas,Despejes,Errores,Duelos_aereos_ganados,Duelos_aereos_perdidos,Porcent_duelos_aereos
1,1,1,0,0,1,0,2,"0,00%",2,0,0,0,2,3,1,0,0,3,"0,00%"
2,4,3,3,1,0,2,4,"50,00%",2,1,0,1,0,4,1,0,3,0,"100,00%"
3,9,6,6,1,2,3,8,"37,50%",5,7,2,5,3,12,0,0,0,3,"0,00%"
4,10,8,8,2,0,4,7,"57,14%",3,8,2,6,11,21,46,0,25,21,"54,35%"
5,9,5,7,2,0,8,9,"88,89%",1,0,0,0,2,11,3,0,3,1,"75,00%"
6,9,8,4,2,3,1,3,"33,33%",2,5,1,4,1,10,0,0,4,10,"28,57%"
7,0,0,0,0,0,0,0,"0,00%",0,0,0,0,0,0,4,1,0,1,"0,00%"
8,16,11,10,6,0,7,13,"53,85%",6,5,3,2,3,19,3,0,8,4,"66,67%"
9,1,1,0,0,1,1,3,"33,33%",2,3,0,3,2,3,1,0,1,6,"14,29%"
10,3,1,1,2,0,0,1,"0,00%",1,6,0,6,0,3,0,0,3,1,"75,00%"
11,27,16,10,15,2,14,26,"53,85%",12,14,2,12,9,36,20,1,10,13,"43,48%"
12,12,6,3,6,3,3,5,"60,00%",2,2,1,1,7,19,13,0,14,1,"93,33%"
13,8,3,2,5,1,5,12,"41,67%",7,12,8,4,7,15,12,0,2,8,"20,00%"
14,0,0,0,0,0,0,0,"0,00%",0,0,0,0,0,0,0,0,2,1,"66,67%"
15,0,0,0,0,0,0,1,"0,00%",1,3,2,1,0,0,1,0,0,0,"0,00%"
16,15,8,5,6,4,5,9,"55,56%",4,4,0,4,7,22,0,0,3,2,"60,00%"
17,19,13,10,8,1,16,30,"53,33%",14,7,2,5,4,23,3,0,2,0,"100,00%"
18,1,1,0,1,0,0,0,"0,00%",0,2,2,0,0,1,2,0,1,2,"33,33%"
19,4,4,2,2,0,2,3,"66,67%",1,5,0,5,1,5,0,0,1,0,"100,00%"
20,0,0,0,0,0,0,2,"0,00%",2,0,0,0,0,0,1,1,0,0,"0,00%"
21,5,2,3,1,1,3,6,"50,00%",3,7,4,3,6,11,18,0,8,5,"61,54%"
22,0,0,0,0,0,0,0,"0,00%",0,1,1,0,2,2,1,0,0,0,"0,00%"
23,15,8,6,8,1,8,12,"66,67%",4,5,1,4,11,26,18,0,17,19,"47,22%"
24,5,3,0,2,3,0,5,"0,00%",5,1,0,1,2,7,1,0,4,2,"66,67%"
25,3,2,1,0,2,2,4,"50,00%",2,0,0,0,2,5,1,0,0,1,"0,00%"
26,10,7,3,6,1,5,6,"83,33%",1,13,7,6,5,15,10,0,5,3,"62,50%"
27,0,0,0,0,0,0,0,"0,00%",0,0,0,0,0,0,0,0,0,0,"0,00%"
28,2,2,1,0,1,1,1,"100,00%",0,1,0,1,1,3,0,0,0,1,"0,00%"
29,4,2,1,1,2,1,2,"50,00%",1,3,2,1,2,6,3,0,4,4,"50,00%"
30,0,0,0,0,0,0,0,"0,00%",0,0,0,0,0,0,0,0,1,0,"100,00%"
31,1,0,1,0,0,0,0,"0,00%",0,2,1,1,0,1,0,0,2,4,"33,33%"
32,4,1,0,4,0,1,6,"16,67%",5,4,1,3,1,5,1,0,1,4,"20,00%"
33,5,3,2,2,1,1,2,"50,00%",1,1,0,1,0,5,1,0,0,9,"0,00%"
34,0,0,0,0,0,0,1,"0,00%",1,0,0,0,1,1,2,0,2,1,"66,67%"
35,2,2,1,1,0,0,0,"0,00%",0,2,0,2,0,2,2,0,1,1,"50,00%"
36,1,0,0,1,0,1,2,"50,00%",1,4,0,4,5,6,3,0,1,1,"50,00%"
37,4,1,2,1,1,2,2,"100,00%",0,0,0,0,2,6,5,0,0,1,"0,00%"
38,7,3,2,3,2,2,9,"22,22%",7,2,0,2,3,10,1,0,0,3,"0,00%"
39,0,0,0,0,0,0,1,"0,00%",1,4,0,4,0,0,3,0,3,3,"50,00%"
40,1,0,0,0,1,0,0,"0,00%",0,0,0,0,0,1,0,0,1,0,"100,00%"
41,13,9,4,7,2,5,9,"55,56%",4,10,4,6,5,18,9,1,7,6,"53,85%"
42,0,0,0,0,0,0,0,"0,00%",0,0,0,0,0,0,0,0,0,1,"0,00%"
43,7,5,5,1,1,5,5,"100,00%",0,5,0,5,3,10,6,1,2,1,"66,67%"
44,2,0,1,1,0,0,1,"0,00%",1,0,0,0,0,2,1,0,1,1,"50,00%"
45,14,9,8,5,1,6,12,"50,00%",6,13,3,10,17,31,11,0,6,6,"50,00%"
46,6,5,2,4,0,4,5,"80,00%",1,4,4,0,15,21,8,0,5,4,"55,56%"
47,6,4,1,3,2,5,6,"83,33%",1,0,0,0,1,7,0,0,0,2,"0,00%"
48,9,5,2,3,4,7,8,"87,50%",1,6,0,6,4,13,5,0,5,1,"83,33%"
49,0,0,0,0,0,0,1,"0,00%",1,2,0,2,0,0,1,0,0,3,"0,00%"
50,11,6,3,7,1,3,11,"27,27%",8,5,4,1,13,24,12,1,16,7,"69,57%"
51,2,2,1,1,0,1,2,"50,00%",1,4,2,2,5,7,1,0,0,2,"0,00%"
52,2,1,0,2,0,1,1,"100,00%",0,0,0,0,0,2,0,0,0,0,"0,00%"
53,0,0,0,0,0,0,0,"0,00%",0,0,0,0,0,0,1,0,0,1,"0,00%"
54,23,14,10,11,2,9,24,"37,50%",15,14,1,13,2,25,11,0,3,11,"21,43%"
55,9,3,4,4,1,4,8,"50,00%",4,11,7,4,3,12,5,0,2,4,"33,33%"
56,0,0,0,0,0,0,0,"0,00%",0,0,0,0,0,0,0,0,0,0,"0,00%"
57,0,0,0,0,0,0,0,"0,00%",0,0,0,0,0,0,0,0,0,1,"0,00%"
58,14,9,8,4,2,7,11,"63,64%",4,9,4,5,7,21,23,0,6,8,"42,86%"
59,0,0,0,0,0,0,2,"0,00%",2,0,0,0,0,0,0,0,1,6,"14,29%"
60,20,8,17,3,0,10,16,"62,50%",6,14,5,9,9,29,32,0,18,9,"66,67%"
61,8,1,7,1,0,3,5,"60,00%",2,3,1,2,10,18,14,0,10,4,"71,43%"
62,3,1,2,0,1,2,2,"100,00%",0,1,0,1,0,3,0,0,0,0,"0,00%"
63,2,1,2,0,0,1,3,"33,33%",2,2,0,2,1,3,2,0,3,1,"75,00%"
64,4,3,1,2,1,2,3,"66,67%",1,3,2,1,1,5,1,0,0,7,"0,00%"
65,15,8,9,3,3,8,16,"50,00%",8,15,4,11,13,28,8,0,10,14,"41,67%"
66,26,13,11,10,5,5,10,"50,00%",5,5,0,5,7,33,2,0,6,12,"33,33%"
67,12,7,4,7,1,6,8,"75,00%",2,5,2,3,5,17,4,0,6,10,"37,50%"
68,2,2,1,0,1,0,1,"0,00%",1,5,0,5,0,2,8,0,3,10,"23,08%"
69,13,9,2,8,3,7,10,"70,00%",3,5,0,5,4,17,0,0,1,2,"33,33%"
70,3,1,0,1,2,1,1,"100,00%",0,2,0,2,1,4,1,0,1,4,"20,00%"
71,0,0,0,0,0,0,0,"0,00%",0,1,0,1,0,0,1,0,0,1,"0,00%"
72,10,6,9,1,0,4,7,"57,14%",3,6,3,3,5,15,16,1,5,6,"45,45%"
73,11,7,9,1,1,7,10,"70,00%",3,3,1,2,1,12,2,0,1,2,"33,33%"
74,15,6,9,3,3,5,7,"71,43%",2,11,1,10,6,21,14,0,2,3,"40,00%"
75,4,1,3,1,0,2,8,"25,00%",6,2,0,2,6,10,4,0,3,0,"100,00%"
76,2,1,2,0,0,1,2,"50,00%",1,4,1,3,2,4,2,0,2,1,"66,67%"
77,0,0,0,0,0,0,0,"0,00%",0,0,0,0,0,0,2,0,1,0,"100,00%"
78,17,10,6,6,5,10,14,"71,43%",4,6,2,4,4,21,9,1,7,6,"53,85%"
79,1,0,0,0,1,0,0,"0,00%",0,0,0,0,0,1,0,0,0,0,"0,00%"
80,0,0,0,0,0,0,1,"0,00%",1,2,1,1,2,2,3,0,0,0,"0,00%"
81,7,5,5,2,0,2,3,"66,67%",1,11,9,2,7,14,30,1,5,8,"38,46%"
82,14,4,10,2,2,5,9,"55,56%",4,1,0,1,7,21,6,0,1,3,"25,00%"
83,2,0,1,1,0,2,4,"50,00%",2,6,6,0,2,4,14,0,6,5,"54,55%"
84,1,0,1,0,0,0,0,"0,00%",0,0,0,0,0,1,0,0,1,0,"100,00%"
85,2,1,0,0,2,0,7,"0,00%",7,3,0,3,0,2,1,0,5,9,"35,71%"
86,0,0,0,0,0,0,1,"0,00%",1,0,0,0,0,0,3,2,0,0,"0,00%"
87,1,0,1,0,0,1,1,"100,00%",0,1,1,0,7,8,7,0,1,1,"50,00%"
88,7,3,2,3,2,2,10,"20,00%",8,5,1,4,2,9,4,0,4,6,"40,00%"
89,6,3,5,1,0,2,5,"40,00%",3,6,2,4,5,11,13,0,5,5,"50,00%"
90,0,0,0,0,0,0,0,"0,00%",0,0,0,0,0,0,0,0,2,9,"18,18%"
91,2,1,0,0,2,0,1,"0,00%",1,1,1,0,0,2,0,0,2,2,"50,00%"
92,18,11,12,4,2,7,18,"38,89%",11,9,5,4,9,27,5,1,6,7,"46,15%"
93,6,3,4,2,0,5,9,"55,56%",4,3,0,3,2,8,2,0,1,3,"25,00%"
94,9,4,8,0,1,5,10,"50,00%",5,3,0,3,0,9,4,0,5,5,"50,00%"
95,2,1,2,0,0,1,1,"100,00%",0,0,0,0,0,2,2,0,0,1,"0,00%"
96,8,8,1,6,1,4,7,"57,14%",3,2,0,2,4,12,2,1,7,2,"77,78%"
97,5,4,3,2,0,3,4,"75,00%",1,5,1,4,1,6,4,0,5,3,"62,50%"
98,0,0,0,0,0,0,1,"0,00%",1,1,0,1,0,0,1,0,0,0,"0,00%"
99,0,0,0,0,0,0,0,"0,00%",0,0,0,0,0,0,0,0,0,0,"0,00%"
100,17,10,15,2,0,10,20,"50,00%",10,9,3,6,15,32,12,0,3,1,"75,00%"
101,16,11,5,8,3,8,20,"40,00%",12,5,3,2,8,24,7,0,7,5,"58,33%"
102,26,17,17,6,3,11,32,"34,38%",21,12,0,12,6,32,11,0,3,3,"50,00%"
103,16,12,7,8,1,7,11,"63,64%",4,13,4,9,13,29,6,1,3,7,"30,00%"
104,4,2,3,1,0,3,7,"42,86%",4,3,0,3,0,4,0,0,0,1,"0,00%"
105,10,7,3,5,2,4,8,"50,00%",4,3,0,3,3,13,3,0,3,2,"60,00%"
106,8,4,5,2,1,5,8,"62,50%",3,9,0,9,4,12,9,0,3,6,"33,33%"
107,0,0,0,0,0,0,1,"0,00%",1,0,0,0,0,0,0,0,0,1,"0,00%"
108,7,3,5,1,1,4,6,"66,67%",2,3,1,2,3,10,15,0,8,10,"44,44%"
109,5,2,4,1,0,1,5,"20,00%",4,2,1,1,4,9,16,0,6,5,"54,55%"
110,6,4,5,0,1,3,7,"42,86%",4,7,4,3,3,9,10,1,3,4,"42,86%"
111,7,4,3,3,1,4,8,"50,00%",4,6,0,6,1,8,1,0,0,2,"0,00%"
112,3,2,2,1,0,2,4,"50,00%",2,2,1,1,4,7,15,0,6,3,"66,67%"
113,18,11,10,6,2,10,19,"52,63%",9,15,4,11,7,25,20,0,6,7,"46,15%"
114,2,1,0,2,0,0,4,"0,00%",4,3,1,2,0,2,0,0,0,1,"0,00%"
115,0,0,0,0,0,0,0,"0,00%",0,2,1,1,0,0,1,0,1,0,"100,00%"
116,4,1,0,4,0,1,1,"100,00%",0,6,0,6,0,4,0,0,0,0,"0,00%"
117,2,1,0,1,1,0,0,"0,00%",0,1,0,1,2,4,0,0,0,0,"0,00%"
118,1,1,1,0,0,0,0,"0,00%",0,1,1,0,0,1,2,0,1,3,"25,00%"
119,8,6,6,2,0,5,10,"50,00%",5,4,4,0,5,13,17,0,10,3,"76,92%"
120,0,0,0,0,0,0,0,"0,00%",0,0,0,0,0,0,0,0,0,0,"0,00%"
121,2,1,0,2,0,0,3,"0,00%",3,5,0,5,1,3,2,0,1,0,"100,00%"
122,0,0,0,0,0,0,0,"0,00%",0,2,0,2,0,0,0,0,0,0,"0,00%"
123,12,8,4,6,2,4,7,"57,14%",3,8,4,4,4,16,5,0,3,4,"42,86%"
124,11,6,5,3,3,3,7,"42,86%",4,5,2,3,7,18,4,0,3,6,"33,33%"
125,3,1,0,0,3,1,3,"33,33%",2,4,0,4,1,4,6,0,18,14,"56,25%"
126,4,1,2,1,1,1,1,"100,00%",0,2,2,0,3,7,4,0,4,0,"100,00%"
127,9,8,7,1,1,4,6,"66,67%",2,4,2,2,9,18,8,0,8,14,"36,36%"
128,6,1,3,3,0,2,5,"40,00%",3,4,1,3,5,11,2,0,0,2,"0,00%"
129,5,2,3,0,2,2,7,"28,57%",5,2,0,2,4,9,0,0,0,0,"0,00%"
130,8,3,6,2,0,5,6,"83,33%",1,4,2,2,6,14,18,1,6,5,"54,55%"
131,0,0,0,0,0,0,0,"0,00%",0,0,0,0,0,0,2,0,0,0,"0,00%"
132,0,0,0,0,0,0,3,"0,00%",3,0,0,0,1,1,2,0,6,14,"30,00%"
133,11,8,3,6,2,5,13,"38,46%",8,10,0,10,2,13,1,0,6,5,"54,55%"
134,0,0,0,0,0,0,0,"0,00%",0,1,0,1,0,0,1,0,0,1,"0,00%"
135,1,1,1,0,0,1,1,"100,00%",0,0,0,0,0,1,1,0,0,0,"0,00%"
136,1,1,0,1,0,0,0,"0,00%",0,3,0,3,0,1,1,0,6,6,"50,00%"
137,11,4,7,2,2,5,7,"71,43%",2,4,1,3,3,14,10,0,5,3,"62,50%"
138,2,0,0,1,1,2,3,"66,67%",1,9,2,7,0,2,0,1,1,3,"25,00%"
139,2,1,1,1,0,0,4,"0,00%",4,1,0,1,0,2,1,0,1,4,"20,00%"
140,2,2,1,1,0,1,1,"100,00%",0,0,0,0,1,3,0,0,0,0,"0,00%"
141,0,0,0,0,0,0,0,"0,00%",0,0,0,0,0,0,3,0,2,0,"100,00%"
142,0,0,0,0,0,0,0,"0,00%",0,0,0,0,1,1,1,0,0,0,"0,00%"
143,1,1,1,0,0,0,2,"0,00%",2,0,0,0,0,1,3,1,4,0,"100,00%"
144,12,7,8,4,0,8,12,"66,67%",4,7,0,7,8,20,4,0,2,4,"33,33%"
145,12,9,6,5,1,8,8,"100,00%",0,9,0,9,8,20,7,0,7,4,"63,64%"
146,2,1,0,0,2,1,1,"100,00%",0,4,0,4,1,3,0,0,0,8,"0,00%"
147,3,1,0,2,1,2,6,"33,33%",4,1,1,0,4,7,5,0,4,3,"57,14%"
148,7,2,6,1,0,3,6,"50,00%",3,3,0,3,7,14,11,0,6,3,"66,67%"
149,0,0,0,0,0,0,0,"0,00%",0,0,0,0,0,0,0,0,0,0,"0,00%"
150,2,1,1,1,0,1,3,"33,33%",2,2,1,1,4,6,0,0,2,0,"100,00%"
151,20,11,14,6,0,8,20,"40,00%",12,9,4,5,19,39,28,0,7,9,"43,75%"
152,3,2,2,0,1,1,2,"50,00%",1,0,0,0,0,3,0,0,3,6,"33,33%"
153,22,10,16,5,1,9,15,"60,00%",6,15,5,10,8,30,12,0,0,2,"0,00%"
154,7,6,0,5,2,3,6,"50,00%",3,3,2,1,5,12,13,1,7,2,"77,78%"
155,3,1,2,1,0,0,0,"0,00%",0,3,3,0,4,7,13,0,5,3,"62,50%"
156,5,4,2,2,1,1,1,"100,00%",0,4,0,4,2,7,3,0,4,1,"80,00%"
157,9,3,1,5,3,2,9,"22,22%",7,4,0,4,2,11,5,0,1,2,"33,33%"
158,2,1,2,0,0,1,4,"25,00%",3,7,1,6,3,5,0,0,2,4,"33,33%"
159,4,2,1,1,2,1,3,"33,33%",2,7,0,7,3,7,2,0,0,0,"0,00%"
160,1,1,0,1,0,1,1,"100,00%",0,1,0,1,1,2,0,0,0,2,"0,00%"
161,19,11,13,5,1,10,12,"83,33%",2,5,1,4,9,28,19,1,5,6,"45,45%"
162,2,2,0,2,0,1,3,"33,33%",2,2,1,1,1,3,5,0,4,1,"80,00%"
163,11,7,3,4,4,4,5,"80,00%",1,1,0,1,2,13,0,0,2,1,"66,67%"
164,7,5,1,6,0,1,6,"16,67%",5,3,0,3,3,10,1,0,1,1,"50,00%"
165,4,1,2,1,1,2,4,"50,00%",2,3,1,2,1,5,0,0,1,2,"33,33%"
166,18,10,12,6,0,10,15,"66,67%",5,9,3,6,12,30,22,0,14,15,"48,28%"
167,1,0,0,0,1,0,0,"0,00%",0,0,0,0,0,1,0,0,0,1,"0,00%"
168,4,2,1,2,1,2,3,"66,67%",1,4,0,4,0,4,0,0,0,5,"0,00%"
169,4,2,2,2,0,1,2,"50,00%",1,1,1,0,1,5,4,0,4,4,"50,00%"
170,26,18,13,11,2,15,18,"83,33%",3,14,8,6,7,33,25,0,22,15,"59,46%"
171,7,3,4,3,0,2,4,"50,00%",2,5,1,4,6,13,0,0,4,7,"36,36%"
172,4,2,2,0,2,2,3,"66,67%",1,3,1,2,0,4,0,0,7,3,"70,00%"
173,7,5,1,6,0,2,5,"40,00%",3,4,3,1,8,15,23,2,18,13,"58,06%"
174,13,7,7,3,3,6,7,"85,71%",1,7,4,3,4,17,10,0,8,3,"72,73%"
175,9,6,3,6,0,6,16,"37,50%",10,10,3,7,10,19,19,0,2,7,"22,22%"
176,8,6,3,5,0,2,5,"40,00%",3,0,0,0,1,9,4,0,2,5,"28,57%"
177,0,0,0,0,0,0,0,"0,00%",0,1,0,1,0,0,0,0,2,0,"100,00%"
178,1,1,1,0,0,1,1,"100,00%",0,2,0,2,2,3,1,0,2,0,"100,00%"
179,0,0,0,0,0,0,0,"0,00%",0,2,0,2,1,1,1,0,2,4,"33,33%"
180,0,0,0,0,0,0,0,"0,00%",0,0,0,0,0,0,7,1,0,0,"0,00%"
181,1,0,1,0,0,0,1,"0,00%",1,0,0,0,0,1,0,0,2,1,"66,67%"
182,0,0,0,0,0,0,1,"0,00%",1,0,0,0,0,0,2,0,1,3,"25,00%"
183,9,6,5,2,2,5,11,"45,45%",6,14,4,10,8,17,19,0,26,15,"63,41%"
184,4,2,2,1,1,3,7,"42,86%",4,11,2,9,0,4,16,0,39,26,"60,00%"
185,0,0,0,0,0,0,0,"0,00%",0,0,0,0,0,0,5,0,0,0,"0,00%"
186,10,4,6,3,1,7,11,"63,64%",4,3,1,2,2,12,9,0,1,1,"50,00%"
187,3,0,3,0,0,1,6,"16,67%",5,1,0,1,1,4,1,0,1,2,"33,33%"
188,1,1,0,1,0,1,1,"100,00%",0,0,0,0,0,1,0,0,1,1,"50,00%"
189,8,5,2,6,0,4,8,"50,00%",4,10,0,10,5,13,4,0,2,4,"33,33%"
190,8,1,1,7,0,5,10,"50,00%",5,5,1,4,0,8,2,0,0,2,"0,00%"
191,18,11,4,6,8,7,14,"50,00%",7,4,0,4,3,21,13,0,9,10,"47,37%"
192,3,2,0,0,3,2,4,"50,00%",2,1,0,1,2,5,3,0,5,7,"41,67%"
193,8,5,4,3,1,7,9,"77,78%",2,2,0,2,0,8,1,0,0,1,"0,00%"
194,2,2,0,2,0,0,0,"0,00%",0,1,1,0,0,2,0,0,0,0,"0,00%"
195,14,7,8,6,0,5,14,"35,71%",9,7,1,6,11,25,9,0,8,5,"61,54%"
196,4,3,0,3,1,1,4,"25,00%",3,4,1,3,1,5,4,0,13,18,"41,94%"
197,13,8,4,8,1,2,11,"18,18%",9,8,3,5,9,22,5,0,10,7,"58,82%"
198,2,0,1,1,0,0,3,"0,00%",3,4,0,4,1,3,0,0,0,3,"0,00%"
199,2,1,1,1,0,1,4,"25,00%",3,3,0,3,7,9,2,0,0,0,"0,00%"
200,4,3,3,1,0,0,0,"0,00%",0,1,0,1,0,4,2,0,1,3,"25,00%"
201,1,1,0,1,0,0,1,"0,00%",1,2,0,2,0,1,0,0,1,7,"12,50%"
202,4,4,3,1,0,1,1,"100,00%",0,4,3,1,1,5,5,1,4,1,"80,00%"
203,2,1,2,0,0,2,5,"40,00%",3,0,0,0,0,2,0,0,3,3,"50,00%"
204,2,0,0,1,1,1,1,"100,00%",0,1,0,1,0,2,0,0,3,0,"100,00%"
205,1,0,1,0,0,1,1,"100,00%",0,2,1,1,0,1,2,0,2,0,"100,00%"
206,19,7,7,8,4,8,13,"61,54%",5,4,1,3,9,28,2,0,1,1,"50,00%"
207,8,7,2,5,1,4,10,"40,00%",6,10,2,8,1,9,3,0,4,5,"44,44%"
208,1,0,0,0,1,1,2,"50,00%",1,3,0,3,1,2,0,0,1,0,"100,00%"
209,0,0,0,0,0,0,1,"0,00%",1,0,0,0,1,1,0,0,3,2,"60,00%"
210,8,2,3,5,0,1,2,"50,00%",1,7,0,7,6,14,2,0,8,7,"53,33%"
211,5,4,2,1,2,2,3,"66,67%",1,3,0,3,5,10,0,0,1,6,"14,29%"
212,15,9,8,7,0,10,17,"58,82%",7,2,0,2,4,19,9,0,11,7,"61,11%"
213,1,1,1,0,0,0,0,"0,00%",0,0,0,0,0,1,0,0,0,0,"0,00%"
214,1,1,0,1,0,0,1,"0,00%",1,2,0,2,1,2,1,0,0,4,"0,00%"
215,8,4,2,3,3,4,12,"33,33%",8,4,0,4,1,9,1,0,0,2,"0,00%"
216,0,0,0,0,0,0,0,"0,00%",0,0,0,0,0,0,0,0,0,0,"0,00%"
217,1,1,0,0,1,0,0,"0,00%",0,0,0,0,1,2,0,0,0,1,"0,00%"
218,0,0,0,0,0,0,0,"0,00%",0,0,0,0,0,0,3,0,5,5,"50,00%"
219,1,1,1,0,0,0,0,"0,00%",0,0,0,0,0,1,0,0,1,0,"100,00%"
220,8,5,3,3,2,7,11,"63,64%",4,4,1,3,5,13,7,0,6,9,"40,00%"
221,2,0,1,0,1,1,1,"100,00%",0,4,0,4,0,2,1,0,1,4,"20,00%"
222,3,1,2,1,0,3,3,"100,00%",0,1,0,1,3,6,10,0,1,0,"100,00%"
223,0,0,0,0,0,0,0,"0,00%",0,0,0,0,0,0,0,0,1,0,"100,00%"
224,6,2,1,3,2,1,4,"25,00%",3,8,0,8,2,8,1,0,1,2,"33,33%"
225,6,5,2,1,3,4,5,"80,00%",1,4,1,3,1,7,1,0,0,0,"0,00%"
226,3,1,2,1,0,2,4,"50,00%",2,14,3,11,10,13,5,0,10,11,"47,62%"
227,9,6,4,3,2,4,9,"44,44%",5,0,0,0,5,14,4,0,3,1,"75,00%"
228,4,2,3,1,0,2,3,"66,67%",1,1,0,1,4,8,5,0,1,2,"33,33%"
229,2,2,2,0,0,2,4,"50,00%",2,3,1,2,2,4,7,0,5,2,"71,43%"
230,7,6,2,3,2,2,4,"50,00%",2,4,1,3,5,12,1,0,5,5,"50,00%"
231,1,1,1,0,0,0,0,"0,00%",0,2,0,2,0,1,0,0,2,3,"40,00%"
232,4,3,1,0,3,0,2,"0,00%",2,5,0,5,4,8,3,0,6,3,"66,67%"
233,0,0,0,0,0,0,1,"0,00%",1,6,3,3,4,4,5,0,7,2,"77,78%"
234,0,0,0,0,0,0,2,"0,00%",2,2,0,2,2,2,0,0,0,1,"0,00%"
235,5,5,4,1,0,3,6,"50,00%",3,3,0,3,6,11,5,0,2,1,"66,67%"
236,7,6,1,5,1,3,9,"33,33%",6,7,0,7,2,9,15,0,50,36,"58,14%"
237,8,3,4,3,1,2,11,"18,18%",9,6,0,6,0,8,2,0,0,3,"0,00%"
238,10,6,7,3,0,4,6,"66,67%",2,6,4,2,4,14,24,0,8,3,"72,73%"
239,6,3,1,5,0,3,7,"42,86%",4,8,3,5,5,11,19,0,1,1,"50,00%"
240,4,2,2,2,0,3,3,"100,00%",0,2,1,1,5,9,6,2,7,0,"100,00%"
241,2,2,0,1,1,1,3,"33,33%",2,0,0,0,3,5,0,0,0,3,"0,00%"
242,4,1,2,2,0,1,2,"50,00%",1,4,0,4,2,6,2,0,6,4,"60,00%"
243,1,0,1,0,0,1,1,"100,00%",0,0,0,0,0,1,0,0,0,2,"0,00%"
244,8,4,3,3,2,5,7,"71,43%",2,5,0,5,3,11,0,0,1,4,"20,00%"
245,16,9,6,7,3,6,17,"35,29%",11,13,3,10,7,23,7,1,7,6,"53,85%"
246,20,13,13,5,2,10,14,"71,43%",4,1,0,1,5,25,10,0,5,9,"35,71%"
247,7,3,2,3,2,4,12,"33,33%",8,5,1,4,3,10,2,0,1,4,"20,00%"
248,12,6,2,10,0,5,9,"55,56%",4,3,0,3,4,16,1,0,5,2,"71,43%"
249,0,0,0,0,0,0,1,"0,00%",1,0,0,0,0,0,1,0,1,0,"100,00%"
250,6,5,2,3,1,2,3,"66,67%",1,2,1,1,3,9,3,0,5,2,"71,43%"
251,0,0,0,0,0,0,1,"0,00%",1,0,0,0,0,0,0,0,0,0,"0,00%"
252,8,5,4,3,1,5,13,"38,46%",8,10,3,7,4,12,6,0,4,8,"33,33%"
253,7,5,3,3,1,4,7,"57,14%",3,5,1,4,2,9,1,0,4,7,"36,36%"
254,1,1,1,0,0,1,6,"16,67%",5,1,0,1,0,1,0,0,0,1,"0,00%"
255,25,10,11,8,6,16,33,"48,48%",17,13,4,9,13,38,17,0,5,10,"33,33%"
256,5,5,4,0,1,2,3,"66,67%",1,4,1,3,4,9,11,0,12,9,"57,14%"
257,3,2,2,0,1,1,8,"12,50%",7,4,2,2,2,5,14,0,13,7,"65,00%"
258,0,0,0,0,0,0,0,"0,00%",0,0,0,0,0,0,1,0,1,0,"100,00%"
259,4,3,1,2,1,3,5,"60,00%",2,3,2,1,6,10,1,0,1,3,"25,00%"
260,7,4,2,3,2,1,4,"25,00%",3,5,2,3,10,17,10,0,3,4,"42,86%"
261,1,0,1,0,0,0,0,"0,00%",0,0,0,0,1,2,0,0,0,1,"0,00%"
262,0,0,0,0,0,0,0,"0,00%",0,0,0,0,0,0,0,2,0,0,"0,00%"
263,12,8,5,4,3,4,12,"33,33%",8,8,1,7,7,19,6,0,9,9,"50,00%"
264,9,6,5,4,0,4,10,"40,00%",6,3,2,1,4,13,25,1,3,6,"33,33%"
265,1,0,0,1,0,1,2,"50,00%",1,5,0,5,2,3,3,0,17,11,"60,71%"
266,12,9,4,7,1,4,5,"80,00%",1,5,1,4,10,22,4,0,3,4,"42,86%"
267,9,6,4,4,1,3,12,"25,00%",9,2,0,2,8,17,7,0,4,3,"57,14%"
268,5,3,2,0,3,5,5,"100,00%",0,2,0,2,2,7,1,0,1,1,"50,00%"
269,0,0,0,0,0,0,0,"0,00%",0,1,0,1,0,0,0,0,3,5,"37,50%"
270,1,0,0,1,0,0,3,"0,00%",3,2,0,2,6,7,2,0,1,1,"50,00%"
271,1,0,0,1,0,1,2,"50,00%",1,3,1,2,3,4,1,0,3,5,"37,50%"
272,0,0,0,0,0,0,0,"0,00%",0,0,0,0,1,1,1,1,0,0,"0,00%"
273,2,2,1,1,0,1,2,"50,00%",1,7,2,5,2,4,9,0,4,1,"80,00%"
274,5,1,2,3,0,2,3,"66,67%",1,4,0,4,3,8,5,0,1,3,"25,00%"
275,12,5,6,3,3,7,8,"87,50%",1,6,0,6,4,16,12,0,4,0,"100,00%"
276,6,3,0,3,3,1,7,"14,29%",6,9,1,8,1,7,4,0,17,17,"50,00%"
277,0,0,0,0,0,0,1,"0,00%",1,1,0,1,1,1,0,0,0,0,"0,00%"
278,3,1,1,2,0,3,6,"50,00%",3,3,1,2,3,6,3,0,1,3,"25,00%"
279,7,5,4,2,1,4,7,"57,14%",3,0,0,0,2,9,3,0,1,1,"50,00%"
280,8,3,7,0,1,1,2,"50,00%",1,9,7,2,7,15,22,0,6,7,"46,15%"
281,7,2,1,2,4,4,7,"57,14%",3,2,0,2,3,10,1,0,0,2,"0,00%"
282,1,1,0,0,1,0,0,"0,00%",0,0,0,0,0,1,4,0,1,0,"100,00%"
283,5,2,3,2,0,5,9,"55,56%",4,2,1,1,3,8,4,0,1,2,"33,33%"
284,1,1,0,0,1,1,3,"33,33%",2,2,1,1,2,3,9,0,2,3,"40,00%"
285,3,2,3,0,0,2,3,"66,67%",1,3,2,1,8,11,2,0,4,2,"66,67%"
286,27,16,12,12,3,10,18,"55,56%",8,7,2,5,6,33,21,2,10,10,"50,00%"
287,10,4,5,2,3,2,8,"25,00%",6,2,0,2,1,11,3,0,1,3,"25,00%"
288,19,11,10,8,1,11,15,"73,33%",4,4,2,2,6,25,14,0,4,7,"36,36%"
289,2,2,2,0,0,0,3,"0,00%",3,2,0,2,0,2,7,0,10,8,"55,56%"
290,5,1,3,2,0,4,8,"50,00%",4,2,0,2,4,9,10,0,0,1,"0,00%"
291,0,0,0,0,0,0,0,"0,00%",0,0,0,0,0,0,1,1,0,0,"0,00%"
292,2,1,1,0,1,2,4,"50,00%",2,0,0,0,3,5,1,0,1,0,"100,00%"
293,8,5,3,5,0,4,9,"44,44%",5,10,5,5,7,15,17,0,3,3,"50,00%"
294,12,8,8,3,1,9,20,"45,00%",11,7,4,3,11,23,6,0,5,1,"83,33%"
295,0,0,0,0,0,0,1,"0,00%",1,0,0,0,1,1,1,0,1,0,"100,00%"
296,4,1,4,0,0,2,6,"33,33%",4,7,3,4,5,9,21,0,5,6,"45,45%"
297,6,3,3,3,0,3,11,"27,27%",8,2,0,2,5,11,1,0,5,6,"45,45%"
298,0,0,0,0,0,0,0,"0,00%",0,0,0,0,0,0,0,1,0,0,"0,00%"
299,7,2,1,6,0,3,7,"42,86%",4,3,1,2,6,13,1,0,4,3,"57,14%"
300,4,3,2,2,0,2,2,"100,00%",0,1,1,0,1,5,1,1,1,0,"100,00%"
301,20,9,11,8,1,11,23,"47,83%",12,7,3,4,3,23,18,2,4,3,"57,14%"
302,14,8,10,4,0,6,15,"40,00%",9,13,1,12,7,21,11,0,3,6,"33,33%"
303,2,1,1,1,0,1,1,"100,00%",0,0,0,0,1,3,1,0,2,1,"66,67%"
304,1,0,0,1,0,1,1,"100,00%",0,2,0,2,0,1,1,0,2,7,"22,22%"
305,4,2,2,2,0,1,4,"25,00%",3,0,0,0,1,5,1,0,1,2,"33,33%"
306,12,7,9,2,1,4,10,"40,00%",6,7,3,4,5,17,12,0,1,3,"25,00%"
307,5,5,4,1,0,3,5,"60,00%",2,5,4,1,5,10,5,0,4,2,"66,67%"
308,8,4,5,3,0,4,8,"50,00%",4,16,11,5,8,16,15,1,7,2,"77,78%"
309,3,1,1,2,0,0,1,"0,00%",1,5,5,0,1,4,6,0,1,6,"14,29%"
310,2,0,2,0,0,1,3,"33,33%",2,2,1,1,7,9,5,0,1,5,"16,67%"
311,4,0,2,1,1,3,4,"75,00%",1,5,0,5,2,6,3,0,3,6,"33,33%"
312,2,0,0,2,0,1,1,"100,00%",0,3,0,3,1,3,0,0,2,0,"100,00%"
313,4,3,1,3,0,1,3,"33,33%",2,5,1,4,3,7,2,0,5,2,"71,43%"
314,4,2,2,2,0,2,5,"40,00%",3,6,3,3,4,8,2,1,1,0,"100,00%"
315,14,6,8,4,2,5,7,"71,43%",2,13,0,13,11,25,6,0,2,3,"40,00%"
316,3,2,2,1,0,1,2,"50,00%",1,2,0,2,0,3,1,0,6,4,"60,00%"
317,10,7,7,3,0,4,12,"33,33%",8,8,0,8,1,11,1,0,1,2,"33,33%"
318,12,7,8,3,1,9,11,"81,82%",2,4,2,2,5,17,9,0,2,2,"50,00%"
319,2,1,0,2,0,0,1,"0,00%",1,3,0,3,0,2,2,0,3,12,"20,00%"
320,4,3,1,1,2,1,2,"50,00%",1,1,0,1,0,4,0,0,0,2,"0,00%"
321,15,8,11,4,0,4,9,"44,44%",5,12,6,6,7,22,17,0,11,11,"50,00%"
322,13,5,6,5,2,4,16,"25,00%",12,9,0,9,14,27,5,0,7,2,"77,78%"
323,17,9,9,6,2,11,19,"57,89%",8,9,3,6,9,26,7,0,6,10,"37,50%"
324,0,0,0,0,0,0,1,"0,00%",1,2,1,1,4,4,1,1,0,1,"0,00%"
325,4,2,0,3,1,4,6,"66,67%",2,1,0,1,1,5,0,0,1,4,"20,00%"
326,8,6,4,3,1,2,3,"66,67%",1,1,0,1,3,11,2,1,0,0,"0,00%"
327,1,0,0,1,0,0,3,"0,00%",3,2,1,1,2,3,6,0,18,10,"64,29%"
328,3,2,0,0,3,2,4,"50,00%",2,2,0,2,2,5,0,0,0,2,"0,00%"
329,0,0,0,0,0,0,0,"0,00%",0,0,0,0,0,0,1,0,1,5,"16,67%"
330,1,1,0,1,0,0,0,"0,00%",0,1,0,1,0,1,0,0,2,5,"28,57%"
331,6,3,3,1,2,1,3,"33,33%",2,4,0,4,1,7,0,0,1,7,"12,50%"
332,6,2,2,3,1,2,3,"66,67%",1,2,0,2,2,8,0,0,2,4,"33,33%"
333,2,1,2,0,0,2,3,"66,67%",1,4,3,1,10,12,21,0,10,8,"55,56%"
334,19,11,9,9,1,8,27,"29,63%",19,18,5,13,20,39,7,0,3,3,"50,00%"
335,2,2,1,1,0,0,0,"0,00%",0,1,0,1,2,4,2,0,1,0,"100,00%"
336,10,5,8,1,1,3,11,"27,27%",8,5,2,3,5,15,12,0,4,6,"40,00%"
337,6,4,4,2,0,5,8,"62,50%",3,10,5,5,6,12,24,0,6,8,"42,86%"
338,21,11,6,10,5,9,18,"50,00%",9,10,2,8,4,25,2,0,0,1,"0,00%"
339,0,0,0,0,0,0,4,"0,00%",4,1,0,1,0,0,2,0,1,4,"20,00%"
340,0,0,0,0,0,0,1,"0,00%",1,0,0,0,0,0,1,0,2,0,"100,00%"
341,3,1,3,0,0,2,2,"100,00%",0,3,1,2,0,3,0,0,0,0,"0,00%"
342,9,6,7,2,0,0,6,"0,00%",6,3,1,2,6,15,1,0,1,4,"20,00%"
343,0,0,0,0,0,0,0,"0,00%",0,0,0,0,0,0,1,0,1,0,"100,00%"
344,1,0,1,0,0,1,1,"100,00%",0,0,0,0,0,1,1,0,0,0,"0,00%"
345,0,0,0,0,0,0,0,"0,00%",0,0,0,0,0,0,0,0,1,1,"50,00%"
346,2,1,1,1,0,0,3,"0,00%",3,2,1,1,1,3,0,0,4,0,"100,00%"
347,5,3,3,2,0,3,4,"75,00%",1,1,0,1,1,6,3,0,2,0,"100,00%"
348,4,4,1,2,1,0,0,"0,00%",0,4,2,2,2,6,0,0,10,19,"34,48%"
349,6,5,4,2,0,3,3,"100,00%",0,4,3,1,1,7,11,0,7,2,"77,78%"
350,8,4,1,6,1,5,5,"100,00%",0,4,0,4,7,15,2,0,3,4,"42,86%"
351,10,7,3,6,1,5,11,"45,45%",6,8,1,7,2,12,12,1,2,5,"28,57%"
352,1,1,1,0,0,1,3,"33,33%",2,1,0,1,1,2,0,0,0,2,"0,00%"
353,10,6,7,3,0,5,5,"100,00%",0,3,1,2,4,14,20,0,9,7,"56,25%"
354,8,4,3,2,3,6,16,"37,50%",10,3,1,2,0,8,4,0,1,1,"50,00%"
355,12,7,9,2,1,7,11,"63,64%",4,17,6,11,8,20,21,0,15,18,"45,45%"
356,7,3,5,2,0,7,8,"87,50%",1,1,1,0,3,10,2,0,6,7,"46,15%"
357,11,5,3,7,1,8,16,"50,00%",8,8,1,7,6,17,2,0,2,6,"25,00%"
358,0,0,0,0,0,0,0,"0,00%",0,0,0,0,0,0,0,0,0,0,"0,00%"
359,26,16,11,12,3,11,18,"61,11%",7,7,2,5,9,35,2,0,2,2,"50,00%"
360,17,11,10,5,2,7,21,"33,33%",14,15,8,7,7,24,8,1,12,7,"63,16%"
361,0,0,0,0,0,0,1,"0,00%",1,0,0,0,0,0,0,0,0,0,"0,00%"
362,0,0,0,0,0,0,0,"0,00%",0,0,0,0,0,0,0,0,0,0,"0,00%"
363,5,3,0,4,1,2,4,"50,00%",2,4,0,4,1,6,0,0,0,3,"0,00%"
364,12,10,8,1,3,8,17,"47,06%",9,6,0,6,2,14,5,0,5,10,"33,33%"
365,10,6,4,4,2,3,12,"25,00%",9,4,0,4,2,12,2,0,0,6,"0,00%"
366,4,1,3,1,0,2,3,"66,67%",1,6,0,6,2,6,0,0,2,1,"66,67%"
367,7,3,3,2,2,1,4,"25,00%",3,3,0,3,0,7,1,0,0,4,"0,00%"
368,0,0,0,0,0,0,2,"0,00%",2,0,0,0,3,3,4,0,10,2,"83,33%"
369,0,0,0,0,0,0,0,"0,00%",0,0,0,0,0,0,0,0,0,1,"0,00%"
370,0,0,0,0,0,0,0,"0,00%",0,0,0,0,1,1,1,0,0,0,"0,00%"
371,23,17,12,10,1,7,20,"35,00%",13,5,0,5,9,32,6,0,3,1,"75,00%"
372,3,2,1,1,1,1,1,"100,00%",0,2,0,2,3,6,7,0,7,13,"35,00%"
373,1,1,0,0,1,0,1,"0,00%",1,2,0,2,1,2,0,0,0,0,"0,00%"
374,15,8,7,7,1,6,8,"75,00%",2,6,3,3,7,22,16,0,9,8,"52,94%"
375,6,2,3,3,0,4,6,"66,67%",2,4,0,4,4,10,4,0,2,1,"66,67%"
376,8,4,4,3,1,3,9,"33,33%",6,6,0,6,14,22,5,0,12,5,"70,59%"
377,5,4,0,1,4,1,1,"100,00%",0,3,0,3,1,6,6,0,12,7,"63,16%"
378,1,1,0,1,0,0,0,"0,00%",0,2,1,1,0,1,0,0,1,0,"100,00%"
379,5,3,2,3,0,1,3,"33,33%",2,6,4,2,10,15,21,0,11,6,"64,71%"
380,4,2,3,1,0,1,5,"20,00%",4,11,0,11,2,6,1,0,1,4,"20,00%"
381,0,0,0,0,0,0,0,"0,00%",0,0,0,0,0,0,4,0,1,0,"100,00%"
382,13,6,7,4,2,7,18,"38,89%",11,10,1,9,10,23,7,0,4,3,"57,14%"
383,2,1,1,1,0,1,1,"100,00%",0,3,0,3,2,4,3,0,1,0,"100,00%"
384,0,0,0,0,0,0,0,"0,00%",0,0,0,0,1,1,2,0,0,1,"0,00%"
385,2,2,1,1,0,1,1,"100,00%",0,0,0,0,0,2,0,0,1,1,"50,00%"
386,21,11,7,10,4,11,20,"55,00%",9,7,2,5,5,26,3,1,0,3,"0,00%"
387,9,5,2,3,4,4,6,"66,67%",2,6,0,6,2,11,2,0,2,6,"25,00%"
388,7,4,0,6,1,2,3,"66,67%",1,5,2,3,7,14,3,0,4,4,"50,00%"
389,0,0,0,0,0,0,0,"0,00%",0,0,0,0,0,0,1,0,1,0,"100,00%"
390,0,0,0,0,0,0,0,"0,00%",0,0,0,0,0,0,0,0,0,0,"0,00%"
391,10,6,4,1,5,5,11,"45,45%",6,7,0,7,2,12,3,0,2,5,"28,57%"
392,26,15,8,18,0,9,31,"29,03%",22,11,1,10,27,53,15,0,11,7,"61,11%"
393,3,3,0,1,2,1,1,"100,00%",0,1,0,1,0,3,3,0,8,8,"50,00%"
394,6,3,2,4,0,5,15,"33,33%",10,4,1,3,9,15,12,0,4,4,"50,00%"
395,0,0,0,0,0,0,0,"0,00%",0,0,0,0,0,0,1,0,1,0,"100,00%"
396,0,0,0,0,0,0,0,"0,00%",0,0,0,0,0,0,1,0,0,0,"0,00%"
397,7,3,0,5,2,1,4,"25,00%",3,9,2,7,7,14,1,0,5,3,"62,50%"
398,9,5,1,3,5,5,9,"55,56%",4,1,0,1,1,10,1,0,1,2,"33,33%"
399,0,0,0,0,0,0,0,"0,00%",0,0,0,0,0,0,3,0,5,0,"100,00%"
400,1,0,1,0,0,0,0,"0,00%",0,3,0,3,2,3,1,0,0,3,"0,00%"
401,11,8,9,2,0,9,10,"90,00%",1,8,1,7,5,16,7,0,10,8,"55,56%"
402,10,6,1,4,5,4,5,"80,00%",1,10,1,9,4,14,2,0,9,5,"64,29%"
403,2,1,2,0,0,1,4,"25,00%",3,6,4,2,4,6,12,0,7,6,"53,85%"
404,7,5,3,4,0,5,6,"83,33%",1,7,2,5,1,8,9,0,1,1,"50,00%"
405,6,3,4,2,0,4,7,"57,14%",3,3,2,1,6,12,20,0,8,9,"47,06%"
406,0,0,0,0,0,0,0,"0,00%",0,0,0,0,0,0,0,0,0,0,"0,00%"
407,0,0,0,0,0,0,0,"0,00%",0,0,0,0,0,0,0,0,0,0,"0,00%"
408,12,8,2,6,4,6,17,"35,29%",11,7,0,7,5,17,8,0,4,6,"40,00%"
409,8,4,2,4,2,4,7,"57,14%",3,4,2,2,3,11,5,1,1,2,"33,33%"
410,5,3,2,3,0,4,7,"57,14%",3,7,4,3,3,8,20,0,14,8,"63,64%"
411,1,0,1,0,0,0,1,"0,00%",1,1,0,1,1,2,6,0,1,0,"100,00%"
412,16,12,4,5,7,6,14,"42,86%",8,12,1,11,9,25,8,0,16,25,"39,02%"
413,7,4,1,4,2,2,2,"100,00%",0,1,0,1,0,7,0,0,10,6,"62,50%"
414,1,1,1,0,0,1,4,"25,00%",3,2,0,2,4,5,2,1,2,2,"50,00%"
415,5,3,3,1,1,2,3,"66,67%",1,1,0,1,1,6,0,0,2,3,"40,00%"
416,8,3,4,4,0,5,6,"83,33%",1,0,0,0,3,11,3,0,11,1,"91,67%"
417,1,1,1,0,0,0,1,"0,00%",1,1,0,1,2,3,0,0,1,3,"25,00%"
418,10,4,9,1,0,6,9,"66,67%",3,13,4,9,9,19,35,0,6,1,"85,71%"
419,1,1,0,0,1,1,4,"25,00%",3,3,0,3,1,2,1,0,0,1,"0,00%"
420,7,4,3,3,1,0,1,"0,00%",1,6,0,6,1,8,2,0,8,11,"42,11%"
421,13,9,8,4,1,7,11,"63,64%",4,3,1,2,3,16,11,0,8,12,"40,00%"
422,0,0,0,0,0,0,1,"0,00%",1,0,0,0,0,0,3,0,1,2,"33,33%"
423,14,6,10,2,2,5,5,"100,00%",0,4,1,3,4,18,6,0,5,4,"55,56%"
424,0,0,0,0,0,0,0,"0,00%",0,0,0,0,0,0,1,0,0,0,"0,00%"
425,0,0,0,0,0,0,0,"0,00%",0,0,0,0,0,0,2,0,0,0,"0,00%"
426,3,1,2,1,0,2,5,"40,00%",3,2,0,2,5,8,4,0,1,0,"100,00%"
427,6,3,2,2,2,4,7,"57,14%",3,10,2,8,5,11,3,0,3,6,"33,33%"
428,0,0,0,0,0,0,1,"0,00%",1,0,0,0,0,0,0,0,1,0,"100,00%"
429,11,7,6,5,0,3,9,"33,33%",6,7,5,2,11,22,38,0,20,14,"58,82%"
430,9,9,5,3,1,4,10,"40,00%",6,11,4,7,11,20,11,1,9,7,"56,25%"
431,4,3,2,1,1,3,3,"100,00%",0,1,0,1,0,4,0,0,0,1,"0,00%"
432,1,0,1,0,0,1,1,"100,00%",0,0,0,0,0,1,0,0,0,0,"0,00%"
433,0,0,0,0,0,0,0,"0,00%",0,0,0,0,0,0,0,0,0,0,"0,00%"
434,3,3,3,0,0,2,3,"66,67%",1,0,0,0,0,3,2,0,2,3,"40,00%"
435,11,7,6,4,1,8,18,"44,44%",10,13,1,12,1,12,7,0,2,3,"40,00%"
436,0,0,0,0,0,0,0,"0,00%",0,0,0,0,0,0,0,0,0,0,"0,00%"
437,3,2,2,0,1,3,3,"100,00%",0,1,0,1,3,6,4,0,1,0,"100,00%"
438,0,0,0,0,0,0,0,"0,00%",0,0,0,0,0,0,3,1,4,0,"100,00%"
439,4,4,1,2,1,0,3,"0,00%",3,3,0,3,3,7,0,0,1,0,"100,00%"
440,8,3,1,2,5,2,6,"33,33%",4,3,0,3,3,11,1,1,2,10,"16,67%"
441,13,7,8,4,1,7,10,"70,00%",3,6,1,5,6,19,10,0,2,3,"40,00%"
442,0,0,0,0,0,0,0,"0,00%",0,0,0,0,0,0,0,0,0,0,"0,00%"
443,0,0,0,0,0,0,0,"0,00%",0,0,0,0,1,1,5,0,2,0,"100,00%"
444,2,1,0,1,1,1,3,"33,33%",2,2,0,2,1,3,0,0,3,6,"33,33%"
445,10,5,7,3,0,8,13,"61,54%",5,11,7,4,9,19,37,0,13,7,"65,00%"
446,11,9,6,4,1,3,4,"75,00%",1,5,1,4,2,13,2,0,2,1,"66,67%"
447,12,9,11,0,1,6,6,"100,00%",0,9,8,1,22,34,32,0,32,10,"76,19%"
448,0,0,0,0,0,0,0,"0,00%",0,1,0,1,0,0,5,0,2,9,"18,18%"
449,3,2,2,1,0,2,2,"100,00%",0,1,1,0,0,3,0,0,2,3,"40,00%"
450,11,6,6,5,0,7,11,"63,64%",4,13,5,8,8,19,8,0,5,3,"62,50%"
451,26,17,15,9,2,12,29,"41,38%",17,12,2,10,16,42,11,0,5,5,"50,00%"
452,2,0,2,0,0,0,2,"0,00%",2,5,2,3,0,2,6,0,6,7,"46,15%"
453,4,2,2,1,1,2,5,"40,00%",3,2,1,1,7,11,7,0,6,4,"60,00%"
454,11,2,7,2,2,3,11,"27,27%",8,1,0,1,7,18,3,0,0,0,"0,00%"
455,4,2,1,3,0,2,4,"50,00%",2,3,0,3,5,9,3,0,6,15,"28,57%"
456,9,3,6,1,2,3,6,"50,00%",3,4,1,3,0,9,2,0,1,0,"100,00%"
457,7,3,3,1,3,4,9,"44,44%",5,2,1,1,1,8,4,0,2,10,"16,67%"
458,5,5,0,5,0,3,5,"60,00%",2,2,0,2,4,9,6,1,3,2,"60,00%"
459,0,0,0,0,0,0,1,"0,00%",1,0,0,0,1,1,3,0,2,1,"66,67%"
460,0,0,0,0,0,0,0,"0,00%",0,1,0,1,0,0,3,0,3,2,"60,00%"
461,0,0,0,0,0,0,1,"0,00%",1,4,3,1,1,1,3,0,2,4,"33,33%"
462,1,1,0,1,0,0,3,"0,00%",3,4,0,4,1,2,3,0,8,11,"42,11%"
463,5,1,3,1,1,1,1,"100,00%",0,3,1,2,2,7,3,0,4,3,"57,14%"
464,12,6,4,6,2,3,4,"75,00%",1,3,2,1,4,16,8,0,22,16,"57,89%"
465,2,1,1,0,1,0,0,"0,00%",0,0,0,0,0,2,0,0,1,2,"33,33%"
466,13,6,4,6,3,5,12,"41,67%",7,7,1,6,4,17,2,0,4,5,"44,44%"
467,3,2,1,1,1,1,1,"100,00%",0,2,0,2,0,3,0,0,2,2,"50,00%"
468,1,1,0,1,0,1,4,"25,00%",3,0,0,0,1,2,1,0,0,0,"0,00%"
469,6,1,4,2,0,3,6,"50,00%",3,2,0,2,0,6,1,0,0,9,"0,00%"
470,2,2,1,1,0,2,2,"100,00%",0,0,0,0,0,2,0,0,1,1,"50,00%"
471,1,1,0,1,0,1,1,"100,00%",0,3,1,2,1,2,2,0,2,5,"28,57%"
472,4,3,1,2,1,1,6,"16,67%",5,8,2,6,2,6,2,0,7,17,"29,17%"
473,0,0,0,0,0,0,0,"0,00%",0,3,1,2,1,1,0,0,5,8,"38,46%"
474,4,3,1,2,1,0,7,"0,00%",7,6,0,6,6,10,1,0,1,3,"25,00%"
475,7,2,5,2,0,5,7,"71,43%",2,3,0,3,7,14,16,0,4,1,"80,00%"
476,13,7,8,5,0,4,11,"36,36%",7,9,3,6,13,26,28,0,9,6,"60,00%"
477,9,5,5,4,0,4,12,"33,33%",8,5,4,1,17,26,16,0,7,3,"70,00%"
478,2,1,2,0,0,1,2,"50,00%",1,5,1,4,5,7,5,0,3,1,"75,00%"
479,3,2,3,0,0,0,2,"0,00%",2,0,0,0,1,4,3,0,1,3,"25,00%"
480,8,1,4,4,0,3,5,"60,00%",2,6,1,5,5,13,1,0,7,3,"70,00%"
481,11,7,3,5,3,2,6,"33,33%",4,11,2,9,1,12,1,0,1,2,"33,33%"
482,1,1,0,1,0,0,0,"0,00%",0,1,1,0,0,1,2,0,1,0,"100,00%"
483,0,0,0,0,0,0,0,"0,00%",0,0,0,0,0,0,0,0,0,0,"0,00%"
484,1,1,0,1,0,0,1,"0,00%",1,0,0,0,0,1,1,0,0,1,"0,00%"
485,3,1,1,0,2,2,8,"25,00%",6,1,0,1,2,5,2,0,0,4,"0,00%"
486,2,1,1,1,0,0,1,"0,00%",1,0,0,0,2,4,5,0,3,0,"100,00%"
487,19,14,7,9,3,7,15,"46,67%",8,10,5,5,6,25,8,0,6,11,"35,29%"
488,10,6,3,5,2,5,6,"83,33%",1,7,0,7,4,14,5,0,11,11,"50,00%"
489,6,4,3,2,1,0,2,"0,00%",2,1,0,1,4,10,3,0,3,4,"42,86%"
490,0,0,0,0,0,0,0,"0,00%",0,0,0,0,0,0,0,0,0,0,"0,00%"
491,3,3,2,1,0,0,1,"0,00%",1,5,0,5,1,4,1,0,4,12,"25,00%"
492,0,0,0,0,0,0,0,"0,00%",0,1,0,1,0,0,2,0,0,0,"0,00%"
493,18,7,4,10,4,4,13,"30,77%",9,9,2,7,11,29,4,0,3,3,"50,00%"
494,0,0,0,0,0,0,0,"0,00%",0,0,0,0,0,0,2,0,0,0,"0,00%"
495,0,0,0,0,0,0,0,"0,00%",0,0,0,0,1,1,1,1,0,0,"0,00%"
496,2,2,0,1,1,0,1,"0,00%",1,0,0,0,0,2,0,0,0,0,"0,00%"
497,11,2,6,4,1,7,9,"77,78%",2,11,5,6,7,18,18,0,11,10,"52,38%"
498,4,0,0,3,1,3,4,"75,00%",1,4,0,4,0,4,0,0,2,5,"28,57%"
499,16,13,11,5,0,7,11,"63,64%",4,5,0,5,5,21,14,0,9,15,"37,50%"
500,4,2,4,0,0,2,3,"66,67%",1,0,0,0,0,4,0,0,0,1,"0,00%"
501,0,0,0,0,0,0,0,"0,00%",0,0,0,0,0,0,2,0,3,1,"75,00%"
502,9,5,3,5,1,5,12,"41,67%",7,7,2,5,6,15,14,0,4,3,"57,14%"
503,9,5,5,2,2,7,10,"70,00%",3,12,7,5,8,17,26,0,8,10,"44,44%"
504,0,0,0,0,0,0,1,"0,00%",1,2,1,1,0,0,3,0,5,4,"55,56%"
505,5,4,1,4,0,2,6,"33,33%",4,1,0,1,2,7,0,0,0,4,"0,00%"
506,0,0,0,0,0,0,0,"0,00%",0,0,0,0,0,0,0,1,0,0,"0,00%"
507,5,2,0,2,3,4,5,"80,00%",1,0,0,0,1,6,7,0,16,8,"66,67%"
508,17,11,15,2,0,9,17,"52,94%",8,15,5,10,15,32,32,0,22,17,"56,41%"
509,17,13,8,8,1,6,16,"37,50%",10,10,0,10,1,18,2,0,4,10,"28,57%"
510,1,1,0,0,1,1,1,"100,00%",0,0,0,0,1,2,0,0,0,0,"0,00%"
511,8,4,3,5,0,4,15,"26,67%",11,6,0,6,12,20,7,0,3,5,"37,50%"
512,3,1,0,2,1,1,2,"50,00%",1,4,0,4,1,4,2,1,1,1,"50,00%"
513,1,0,0,1,0,1,1,"100,00%",0,3,0,3,0,1,0,0,0,0,"0,00%"
514,0,0,0,0,0,0,0,"0,00%",0,0,0,0,0,0,0,0,0,0,"0,00%"
515,10,3,6,3,1,6,10,"60,00%",4,7,4,3,3,13,0,0,2,0,"100,00%"
516,3,1,1,1,1,2,2,"100,00%",0,2,0,2,0,3,2,0,1,1,"50,00%"
517,0,0,0,0,0,0,0,"0,00%",0,0,0,0,0,0,5,2,0,0,"0,00%"
518,3,2,1,2,0,0,1,"0,00%",1,2,0,2,0,3,6,0,7,6,"53,85%"
519,2,2,1,1,0,1,1,"100,00%",0,0,0,0,0,2,0,0,0,0,"0,00%"
520,12,9,8,3,1,4,8,"50,00%",4,10,5,5,13,25,20,0,11,10,"52,38%"
521,17,8,12,5,0,6,8,"75,00%",2,7,7,0,3,20,29,1,21,15,"58,33%"
522,1,1,0,0,1,1,2,"50,00%",1,0,0,0,1,2,0,0,0,1,"0,00%"
523,7,2,2,5,0,2,8,"25,00%",6,7,0,7,5,12,1,1,1,0,"100,00%"
524,7,3,1,5,1,4,7,"57,14%",3,4,0,4,3,10,5,0,3,3,"50,00%"
525,0,0,0,0,0,0,0,"0,00%",0,0,0,0,0,0,0,0,0,0,"0,00%"
526,7,4,7,0,0,5,6,"83,33%",1,3,3,0,6,13,15,0,6,4,"60,00%"
527,14,9,13,1,0,6,15,"40,00%",9,5,2,3,5,19,10,0,9,9,"50,00%"
528,10,7,7,3,0,7,8,"87,50%",1,3,2,1,6,16,12,0,5,5,"50,00%"
529,8,4,7,1,0,5,5,"100,00%",0,10,7,3,14,22,54,1,28,7,"80,00%"
530,0,0,0,0,0,0,0,"0,00%",0,0,0,0,0,0,0,0,0,0,"0,00%"
531,19,7,8,9,2,10,20,"50,00%",10,8,5,3,4,23,18,1,10,5,"66,67%"
532,6,4,5,1,0,5,10,"50,00%",5,6,4,2,3,9,20,0,9,9,"50,00%"
533,8,5,2,5,1,3,12,"25,00%",9,2,0,2,2,10,6,0,23,31,"42,59%"
534,2,2,0,2,0,0,0,"0,00%",0,3,0,3,0,2,1,0,0,6,"0,00%"
535,0,0,0,0,0,0,0,"0,00%",0,1,0,1,1,1,0,0,1,0,"100,00%"
536,3,1,1,1,1,0,1,"0,00%",1,3,1,2,1,4,8,0,16,12,"57,14%"
537,2,1,0,1,1,1,3,"33,33%",2,0,0,0,0,2,1,0,3,3,"50,00%"
538,0,0,0,0,0,0,1,"0,00%",1,0,0,0,0,0,1,0,1,2,"33,33%"
539,3,2,0,3,0,1,2,"50,00%",1,3,2,1,3,6,8,0,8,4,"66,67%"
540,5,2,1,3,1,2,6,"33,33%",4,3,0,3,0,5,1,0,3,3,"50,00%"
541,0,0,0,0,0,0,0,"0,00%",0,0,0,0,0,0,0,0,0,0,"0,00%"
542,9,6,2,5,2,4,5,"80,00%",1,3,0,3,1,10,6,0,3,3,"50,00%"
543,14,10,9,3,2,11,14,"78,57%",3,7,1,6,4,18,12,0,1,3,"25,00%"
544,1,0,1,0,0,0,2,"0,00%",2,2,1,1,0,1,0,0,0,0,"0,00%"
545,1,0,0,1,0,1,3,"33,33%",2,3,0,3,0,1,1,0,2,2,"50,00%"
546,2,1,0,1,1,1,2,"50,00%",1,2,0,2,2,4,0,0,3,3,"50,00%"
547,16,8,7,7,2,6,8,"75,00%",2,9,2,7,5,21,3,0,8,3,"72,73%"
548,9,4,2,4,3,2,8,"25,00%",6,5,2,3,4,13,3,0,3,5,"37,50%"
549,11,5,0,7,4,0,5,"0,00%",5,5,1,4,1,12,10,0,25,46,"35,21%"
550,9,5,3,6,0,7,11,"63,64%",4,11,6,5,11,20,25,0,17,11,"60,71%"
551,0,0,0,0,0,0,0,"0,00%",0,0,0,0,0,0,1,0,0,0,"0,00%"
552,8,7,3,3,2,2,6,"33,33%",4,4,1,3,4,12,3,0,1,1,"50,00%"
553,4,3,0,3,1,0,1,"0,00%",1,1,0,1,2,6,1,0,1,0,"100,00%"
554,13,7,8,4,1,10,22,"45,45%",12,7,1,6,7,20,15,0,9,2,"81,82%"
555,7,3,2,3,2,2,6,"33,33%",4,2,0,2,1,8,0,0,3,4,"42,86%"
556,10,7,5,5,0,6,7,"85,71%",1,4,2,2,3,13,17,0,2,7,"22,22%"
557,0,0,0,0,0,0,0,"0,00%",0,0,0,0,0,0,0,0,0,1,"0,00%"
558,14,9,8,6,0,11,14,"78,57%",3,4,0,4,4,18,10,0,4,2,"66,67%"
559,4,2,1,1,2,1,4,"25,00%",3,4,1,3,3,7,1,0,1,1,"50,00%"
560,3,2,0,2,1,1,5,"20,00%",4,2,0,2,3,6,2,1,6,7,"46,15%"
561,3,1,1,2,0,3,5,"60,00%",2,4,2,2,2,5,0,0,4,10,"28,57%"
562,6,2,4,1,1,2,6,"33,33%",4,7,4,3,6,12,8,0,0,1,"0,00%"
563,1,1,1,0,0,1,1,"100,00%",0,0,0,0,0,1,1,0,0,0,"0,00%"
564,5,1,2,3,0,3,4,"75,00%",1,2,0,2,4,9,1,0,2,5,"28,57%"
565,2,0,1,1,0,1,4,"25,00%",3,2,0,2,2,4,5,0,4,3,"57,14%"
566,0,0,0,0,0,0,0,"0,00%",0,0,0,0,0,0,0,0,1,0,"100,00%"
567,11,5,4,7,0,2,7,"28,57%",5,2,0,2,3,14,2,0,1,1,"50,00%"
568,24,15,13,9,2,12,17,"70,59%",5,11,3,8,13,37,9,1,15,11,"57,69%"
569,7,3,3,3,1,3,8,"37,50%",5,13,4,9,9,16,6,0,5,8,"38,46%"
570,14,9,3,10,1,9,17,"52,94%",8,7,3,4,10,24,12,0,17,3,"85,00%"
571,15,6,7,7,1,5,6,"83,33%",1,3,0,3,8,23,5,0,3,4,"42,86%"
572,0,0,0,0,0,0,0,"0,00%",0,4,1,3,1,1,4,0,0,2,"0,00%"
573,9,6,6,2,1,5,9,"55,56%",4,9,4,5,2,11,27,1,19,14,"57,58%"
574,10,6,5,5,0,6,6,"100,00%",0,7,2,5,6,16,26,0,10,5,"66,67%"
575,2,2,0,2,0,1,1,"100,00%",0,2,1,1,3,5,4,0,5,5,"50,00%"
576,6,6,5,0,1,3,9,"33,33%",6,4,2,2,7,13,4,0,4,11,"26,67%"
577,5,1,2,1,2,3,9,"33,33%",6,3,0,3,1,6,4,0,2,4,"33,33%"
578,0,0,0,0,0,0,1,"0,00%",1,1,0,1,0,0,0,0,1,0,"100,00%"
579,0,0,0,0,0,0,0,"0,00%",0,0,0,0,0,0,0,0,0,0,"0,00%"
580,0,0,0,0,0,0,0,"0,00%",0,1,0,1,0,0,4,1,0,0,"0,00%"
581,10,8,7,2,1,5,7,"71,43%",2,4,1,3,5,15,3,0,5,4,"55,56%"
582,7,4,4,2,1,4,11,"36,36%",7,3,0,3,4,11,7,0,6,2,"75,00%"
583,4,3,1,3,0,3,4,"75,00%",1,1,0,1,2,6,1,0,4,5,"44,44%"
584,3,1,2,1,0,2,5,"40,00%",3,3,0,3,2,5,1,0,1,3,"25,00%"
585,5,3,4,1,0,4,4,"100,00%",0,4,1,3,1,6,3,0,5,2,"71,43%"
586,3,0,2,1,0,2,3,"66,67%",1,3,1,2,1,4,0,0,0,3,"0,00%"
587,7,3,0,6,1,0,0,"0,00%",0,3,0,3,0,7,0,0,1,7,"12,50%"
588,0,0,0,0,0,0,0,"0,00%",0,1,1,0,0,0,1,0,2,0,"100,00%"
589,0,0,0,0,0,0,0,"0,00%",0,0,0,0,0,0,0,0,0,0,"0,00%"
590,3,2,2,1,0,0,0,"0,00%",0,2,0,2,5,8,6,0,4,0,"100,00%"
591,5,3,1,4,0,1,1,"100,00%",0,2,1,1,4,9,9,0,6,1,"85,71%"
592,10,7,0,5,5,4,9,"44,44%",5,4,0,4,6,16,0,0,1,7,"12,50%"
593,7,5,7,0,0,6,7,"85,71%",1,4,1,3,2,9,8,0,1,4,"20,00%"
594,13,9,8,4,1,6,9,"66,67%",3,6,1,5,11,24,20,0,5,9,"35,71%"
595,0,0,0,0,0,0,0,"0,00%",0,1,1,0,0,0,0,0,0,0,"0,00%"
596,1,1,1,0,0,1,1,"100,00%",0,1,0,1,0,1,0,0,1,0,"100,00%"
597,3,1,2,0,1,2,3,"66,67%",1,1,0,1,2,5,7,0,6,4,"60,00%"
598,2,2,0,1,1,0,2,"0,00%",2,3,0,3,1,3,3,0,13,14,"48,15%"
599,0,0,0,0,0,0,1,"0,00%",1,0,0,0,0,0,0,0,0,0,"0,00%"
600,11,7,4,7,0,7,12,"58,33%",5,12,3,9,5,16,2,1,4,2,"66,67%"
601,10,8,6,4,0,4,7,"57,14%",3,5,3,2,3,13,16,1,10,4,"71,43%"
602,7,7,6,0,1,5,7,"71,43%",2,9,5,4,4,11,18,0,15,3,"83,33%"
603,19,14,13,5,1,9,15,"60,00%",6,14,3,11,8,27,5,0,1,5,"16,67%"
604,3,1,0,1,2,1,1,"100,00%",0,4,1,3,0,3,2,0,9,16,"36,00%"
605,9,7,4,3,2,2,4,"50,00%",2,1,0,1,2,11,8,1,0,0,"0,00%"
606,6,2,4,2,0,3,7,"42,86%",4,4,0,4,4,10,2,0,1,0,"100,00%"
607,0,0,0,0,0,0,1,"0,00%",1,0,0,0,0,0,2,0,2,7,"22,22%"
608,6,3,2,1,3,3,4,"75,00%",1,7,0,7,1,7,1,0,4,9,"30,77%"
609,11,7,9,2,0,7,11,"63,64%",4,13,4,9,14,25,34,0,10,10,"50,00%"
610,19,10,4,8,7,10,32,"31,25%",22,11,0,11,9,28,5,0,3,2,"60,00%"
611,11,5,2,5,4,7,14,"50,00%",7,7,1,6,1,12,0,0,5,7,"41,67%"
612,8,6,6,1,1,3,4,"75,00%",1,8,6,2,9,17,32,0,13,7,"65,00%"
613,16,9,5,9,2,10,17,"58,82%",7,2,0,2,12,28,7,0,11,3,"78,57%"
614,3,2,0,2,1,1,2,"50,00%",1,3,0,3,0,3,2,0,4,7,"36,36%"
615,0,0,0,0,0,0,0,"0,00%",0,0,0,0,0,0,0,0,1,0,"100,00%"
616,8,4,2,6,0,4,9,"44,44%",5,4,0,4,2,10,4,0,2,4,"33,33%"
617,3,2,1,2,0,1,2,"50,00%",1,4,1,3,2,5,13,0,9,5,"64,29%"
618,4,2,1,2,1,2,3,"66,67%",1,2,0,2,0,4,3,0,2,2,"50,00%"
619,9,6,7,2,0,4,5,"80,00%",1,11,9,2,4,13,24,0,13,9,"59,09%"
620,1,1,1,0,0,0,0,"0,00%",0,2,0,2,5,6,12,0,3,2,"60,00%"
621,3,1,3,0,0,2,3,"66,67%",1,1,0,1,2,5,3,0,8,1,"88,89%"
622,4,4,2,0,2,1,2,"50,00%",1,1,0,1,3,7,1,0,1,1,"50,00%"
623,5,4,3,1,1,2,2,"100,00%",0,7,3,4,3,8,13,0,5,1,"83,33%"
624,0,0,0,0,0,0,0,"0,00%",0,0,0,0,0,0,6,1,2,0,"100,00%"
625,0,0,0,0,0,0,1,"0,00%",1,0,0,0,0,0,1,0,0,2,"0,00%"
626,14,8,4,8,2,7,12,"58,33%",5,10,1,9,18,32,3,0,3,5,"37,50%"
627,12,7,6,5,1,3,7,"42,86%",4,3,0,3,4,16,5,1,2,4,"33,33%"
628,2,1,0,1,1,0,1,"0,00%",1,4,2,2,4,6,0,0,0,2,"0,00%"
629,0,0,0,0,0,0,0,"0,00%",0,0,0,0,0,0,4,0,0,0,"0,00%"
630,8,5,5,2,1,2,3,"66,67%",1,2,0,2,7,15,6,0,3,2,"60,00%"
631,3,1,1,1,1,1,6,"16,67%",5,8,2,6,3,6,2,0,4,7,"36,36%"
632,0,0,0,0,0,0,0,"0,00%",0,0,0,0,0,0,2,0,0,0,"0,00%"
633,10,7,6,3,1,8,10,"80,00%",2,7,1,6,4,14,7,1,1,5,"16,67%"
634,0,0,0,0,0,0,0,"0,00%",0,3,3,0,0,0,5,0,0,0,"0,00%"
635,0,0,0,0,0,0,0,"0,00%",0,0,0,0,0,0,0,0,1,1,"50,00%"
636,18,11,12,5,1,10,28,"35,71%",18,2,1,1,12,30,21,1,6,4,"60,00%"
637,8,2,3,4,1,3,9,"33,33%",6,3,0,3,0,8,2,0,3,2,"60,00%"
638,2,2,2,0,0,1,3,"33,33%",2,6,4,2,4,6,10,0,7,5,"58,33%"
639,5,3,1,1,3,3,10,"30,00%",7,9,1,8,4,9,3,0,2,8,"20,00%"
640,9,6,7,1,1,4,7,"57,14%",3,1,0,1,6,15,5,1,1,0,"100,00%"
641,5,5,5,0,0,3,7,"42,86%",4,9,6,3,6,11,25,0,7,2,"77,78%"
642,12,8,9,3,0,8,11,"72,73%",3,7,4,3,5,17,11,0,3,1,"75,00%"
643,3,2,0,2,1,0,4,"0,00%",4,2,1,1,1,4,1,0,1,0,"100,00%"
644,12,6,11,1,0,6,8,"75,00%",2,12,6,6,9,21,27,0,12,9,"57,14%"
645,0,0,0,0,0,0,2,"0,00%",2,0,0,0,3,3,3,0,0,1,"0,00%"
646,6,2,5,1,0,3,3,"100,00%",0,7,5,2,7,13,17,1,7,6,"53,85%"
647,0,0,0,0,0,0,1,"0,00%",1,0,0,0,0,0,1,0,0,0,"0,00%"
648,8,6,3,4,1,4,16,"25,00%",12,8,0,8,1,9,4,0,5,3,"62,50%"
649,1,1,0,0,1,1,2,"50,00%",1,0,0,0,2,3,1,0,0,1,"0,00%"
650,6,3,1,3,2,4,8,"50,00%",4,8,1,7,0,6,5,0,3,5,"37,50%"
651,8,6,3,5,0,4,8,"50,00%",4,8,5,3,2,10,26,0,10,4,"71,43%"
652,1,1,1,0,0,1,1,"100,00%",0,0,0,0,0,1,0,0,1,0,"100,00%"
653,6,5,4,2,0,4,5,"80,00%",1,2,1,1,4,10,18,0,3,4,"42,86%"
654,8,6,0,3,5,4,11,"36,36%",7,6,0,6,1,9,10,0,15,18,"45,45%"
655,0,0,0,0,0,0,0,"0,00%",0,0,0,0,0,0,4,0,2,0,"100,00%"
656,11,8,2,4,5,4,9,"44,44%",5,9,3,6,4,15,7,0,3,3,"50,00%"
657,11,5,6,5,0,8,11,"72,73%",3,7,4,3,6,17,13,1,7,8,"46,67%"
658,14,9,4,7,3,9,12,"75,00%",3,8,4,4,7,21,6,0,4,7,"36,36%"
659,6,3,3,3,0,3,6,"50,00%",3,4,0,4,4,10,3,0,1,1,"50,00%"
660,7,2,5,2,0,2,6,"33,33%",4,4,1,3,3,10,15,0,1,3,"25,00%"
661,2,2,0,1,1,1,5,"20,00%",4,0,0,0,0,2,0,0,0,1,"0,00%"
662,10,7,4,5,1,5,5,"100,00%",0,5,0,5,7,17,3,0,6,5,"54,55%"
663,1,1,1,0,0,1,1,"100,00%",0,5,0,5,3,4,0,0,3,3,"50,00%"
664,8,4,3,1,4,4,7,"57,14%",3,7,2,5,4,12,10,1,7,7,"50,00%"
665,0,0,0,0,0,0,0,"0,00%",0,0,0,0,0,0,0,0,1,0,"100,00%"
666,2,2,1,1,0,2,2,"100,00%",0,1,1,0,1,3,1,0,0,1,"0,00%"
667,10,4,7,3,0,5,7,"71,43%",2,6,5,1,10,20,12,0,7,5,"58,33%"
668,2,0,0,2,0,0,1,"0,00%",1,3,1,2,2,4,10,0,1,1,"50,00%"
669,10,5,3,4,3,6,9,"66,67%",3,2,0,2,3,13,4,0,4,5,"44,44%"
670,4,1,1,3,0,1,1,"100,00%",0,9,6,3,8,12,14,1,4,5,"44,44%"
671,22,16,13,9,0,11,14,"78,57%",3,12,8,4,10,32,29,0,9,11,"45,00%"
672,19,13,7,11,1,9,19,"47,37%",10,11,3,8,4,23,10,0,3,9,"25,00%"
673,2,2,0,2,0,0,0,"0,00%",0,1,1,0,1,3,0,1,0,3,"0,00%"
674,2,2,0,0,2,1,2,"50,00%",1,0,0,0,0,2,1,0,0,1,"0,00%"
675,0,0,0,0,0,0,0,"0,00%",0,0,0,0,0,0,1,0,0,0,"0,00%"
676,0,0,0,0,0,0,0,"0,00%",0,0,0,0,0,0,1,0,4,0,"100,00%"
677,5,4,1,4,0,2,4,"50,00%",2,3,0,3,2,7,3,0,1,9,"10,00%"
678,0,0,0,0,0,0,1,"0,00%",1,0,0,0,0,0,1,1,2,0,"100,00%"
679,5,3,1,4,0,2,3,"66,67%",1,5,3,2,2,7,6,0,4,9,"30,77%"
680,1,0,1,0,0,0,2,"0,00%",2,2,1,1,0,1,0,0,0,1,"0,00%"
681,19,11,12,6,1,9,21,"42,86%",12,6,0,6,8,27,26,1,7,7,"50,00%"
682,0,0,0,0,0,0,0,"0,00%",0,0,0,0,0,0,0,0,0,0,"0,00%"
683,29,17,10,18,1,7,14,"50,00%",7,8,0,8,13,42,8,1,6,4,"60,00%"
684,7,1,2,3,2,3,9,"33,33%",6,3,0,3,4,11,13,0,3,1,"75,00%"
685,0,0,0,0,0,0,0,"0,00%",0,0,0,0,0,0,0,0,1,0,"100,00%"
686,3,3,1,1,1,1,2,"50,00%",1,0,0,0,1,4,0,0,0,0,"0,00%"
687,14,8,10,4,0,8,11,"72,73%",3,7,3,4,14,28,22,2,11,6,"64,71%"
688,10,9,3,6,1,3,14,"21,43%",11,6,3,3,11,21,11,0,5,9,"35,71%"
689,2,2,1,0,1,2,2,"100,00%",0,1,1,0,0,2,2,0,0,1,"0,00%"
690,18,7,6,7,5,9,20,"45,00%",11,17,1,16,14,32,13,0,7,5,"58,33%"
691,4,2,3,1,0,1,4,"25,00%",3,4,4,0,4,8,22,0,28,8,"77,78%"
692,5,3,2,2,1,2,5,"40,00%",3,10,2,8,4,9,11,0,28,10,"73,68%"
693,3,1,3,0,0,2,3,"66,67%",1,7,6,1,7,10,22,0,5,1,"83,33%"
694,4,1,1,3,0,0,4,"0,00%",4,1,0,1,3,7,4,0,0,0,"0,00%"
695,16,9,5,10,1,6,9,"66,67%",3,4,1,3,2,18,5,0,5,6,"45,45%"
696,0,0,0,0,0,0,1,"0,00%",1,1,1,0,0,0,1,0,0,0,"0,00%"
697,1,0,1,0,0,1,1,"100,00%",0,2,0,2,0,1,0,0,0,2,"0,00%"
698,27,18,12,12,3,9,28,"32,14%",19,13,5,8,6,33,0,2,5,2,"71,43%"
699,8,6,3,4,1,1,11,"9,09%",10,8,1,7,13,21,1,0,2,3,"40,00%"
700,0,0,0,0,0,0,1,"0,00%",1,1,0,1,0,0,5,0,1,0,"100,00%"
701,1,1,0,1,0,0,2,"0,00%",2,2,1,1,0,1,4,0,3,9,"25,00%"
702,5,2,2,2,1,2,5,"40,00%",3,3,2,1,2,7,5,0,4,3,"57,14%"
703,10,4,9,1,0,4,5,"80,00%",1,6,4,2,4,14,21,0,2,3,"40,00%"
704,9,7,4,3,2,7,9,"77,78%",2,1,1,0,3,12,8,0,3,1,"75,00%"
705,0,0,0,0,0,0,0,"0,00%",0,0,0,0,1,1,0,0,1,0,"100,00%"
706,0,0,0,0,0,0,0,"0,00%",0,1,1,0,1,1,6,0,0,1,"0,00%"
707,3,1,2,1,0,1,3,"33,33%",2,2,0,2,1,4,3,0,2,1,"66,67%"
708,2,0,1,1,0,0,5,"0,00%",5,3,0,3,0,2,3,1,0,0,"0,00%"
709,1,0,0,1,0,1,1,"100,00%",0,1,0,1,2,3,4,0,0,0,"0,00%"
710,1,1,1,0,0,1,1,"100,00%",0,0,0,0,0,1,0,0,1,0,"100,00%"
711,6,3,4,2,0,3,6,"50,00%",3,10,9,1,3,9,8,0,13,8,"61,90%"
712,9,6,6,2,1,3,5,"60,00%",2,3,1,2,0,9,5,0,6,4,"60,00%"
713,3,3,1,1,1,2,4,"50,00%",2,3,0,3,2,5,6,0,2,1,"66,67%"
714,3,1,1,1,1,1,2,"50,00%",1,0,0,0,1,4,2,0,0,2,"0,00%"
715,1,1,0,0,1,0,1,"0,00%",1,1,0,1,0,1,0,0,2,3,"40,00%"
716,1,0,1,0,0,0,2,"0,00%",2,0,0,0,3,4,2,0,0,0,"0,00%"
717,2,2,1,1,0,2,5,"40,00%",3,0,0,0,0,2,0,0,0,2,"0,00%"
718,1,1,1,0,0,1,2,"50,00%",1,0,0,0,2,3,1,0,0,0,"0,00%"
719,14,8,4,5,5,4,8,"50,00%",4,5,1,4,14,28,5,0,8,7,"53,33%"
720,2,2,2,0,0,1,1,"100,00%",0,0,0,0,1,3,0,0,1,1,"50,00%"
721,4,0,2,2,0,2,6,"33,33%",4,7,1,6,3,7,2,0,3,1,"75,00%"
722,2,1,0,1,1,0,1,"0,00%",1,4,1,3,0,2,0,0,0,0,"0,00%"
723,8,4,0,6,2,0,2,"0,00%",2,3,0,3,4,12,4,1,1,4,"20,00%"
724,0,0,0,0,0,0,4,"0,00%",4,6,1,5,2,2,0,0,0,2,"0,00%"
725,7,4,4,2,1,0,2,"0,00%",2,4,0,4,4,11,3,0,2,4,"33,33%"
726,1,0,0,0,1,0,0,"0,00%",0,1,1,0,4,5,2,0,0,0,"0,00%"
727,0,0,0,0,0,0,0,"0,00%",0,0,0,0,3,0,0,0,0,0,"0,00%"
